############
###..##..###
###......###
###......###
##..#.....##
##........##
##........##
##........##
###......###
####....####
#####..#####
############